FOREST
11 13
#############
#.........+.#
#.#.#.#.#.#+#
#...........#
#.#+#.#.#.#.#
#.+.+.......#
#.#+#.#.#.#.#
#...........#
#.#.#.#.#.#.#
#.........KD#
#############