WINTER
11 17
#################
#..+....#.......#
#+#+#+#.###.#K#+#
#.+.+.+..++..++.#
#.#+#+#+#+#.#.#D#
#..+.+....++.+..#
#.#+#.#.#.#+#.#+#
#..+.++++.+.+...#
#+#+#+#.#+#.#.#.#
#+....++..++....#
#################