DESERT
11 13
#############
#.+.......+.#
#+#.#.#.#.#K#
#.+......#..#
#.#+#.#.#.###
#...+....+.D#
#.#+#.#.#.###
#.+......#..#
#+#.#.#.#.#.#
#.+.........#
#############